!!!!!!!!!!!!!!!!!!!!!!!!!!!
!                         !
!  P                      !
!                       $ !
! 00011              00000!
!                         !
!                         !
!             N           !
!!!!!!!!!!!!!!!!!!!!!!!!!!!