!!!!!!!!!!!!!!!!!!!!!!!!!!
!                        !
!         0 B           $!
!         00011          !
!  P      N1111          !
!         11111          !
! 00011100000000011110000!
!!!!!!!!!!!!!!!!!!!!!!!!!!