###############################
#                             #
#                             #
#    BB                       #
#    ##                    B  #
#    #                     B  #
# P  N        $        B       #
#####======######     ========#
#                             #
#               ####          #
#               ######        #
#################=============#