!!!!!!!!!!!!!!!!!!!!!!!!!!
!                        !
!         0 B           $!
!         000            !
!  P      N              !
!         1              !
! 00011100000000011110000!
!!!!!!!!!!!!!!!!!!!!!!!!!!