!!!!!!!!!!!!!!!!!!!!!!!!!!!
!                       $1!
!                        1!
!                        1!
!  P                     1!
!                       T1!
! 000111111111111111111111!
!!!!!!!!!!!!!!!!!!!!!!!!!!!