!!!!!!!!!!!!!!!!!!!!!!!!!!!
!                  0000000!
!                  0    $0!
!                  0 J   0!
!                  0     0!
!                  0     0!
!                  0     0!
!          j       0     0!
!  P       1       0     0!
!         111            0!
! 000111111111111111000000!
!!!!!!!!!!!!!!!!!!!!!!!!!!!