########################!
#                       !
#                       !
#                       !
#                       !
#          B            !
#         ##            !
#         T            $!
#                       !
# P                     !
#         N             !
########################!
