!!!!!!!!!!!!!!!!!!!!!!!!!!!
!                         !
! P                       !
!                         !
!0001111111111111111====  !
!!!!!!!!!!!!!!!!!!!!!!!   !
!                         !
!$                        !
!1111111111111111111111111!
!!!!!!!!!!!!!!!!!!!!!!!!!!!